Gill Bates: Jodee Killam, Natacha Osterhoudt, Jom Tones, Verdie Tong, Ossie Digangi
Jom Tones: Marry Blakely, Masako Miguel, Gill Bates
Alton Justis: Verdie Tong, Enrique Litz
Joey Trammell: Jettie Wilham
Rozanne Schiavo: Mikki Yerby
Deena Massi: Milo Charlebois, Vicenta Seidel
Enrique Litz: Levi Strasser, Alton Justis
Sindy Worley: Vallie Taormina, Alysa Robichaux, Ossie Digangi
Yahaira Briones: Zoila Tarpey, Zandra Marsch
Tanesha Vanwinkle: Nestor Valentine, Shawana Mell, Jamar Mcclane
Effie Mestas: Julissa Furry, Masako Miguel
Josef Hill: Travis Valletta, Tawny Munroe
Toshia Quandt: Vallie Taormina, Jeanice Funke
Ferne Dundas: Zoila Tarpey, Margarita Arrey
Aletha Dorey: Sharika Neal, Milo Charlebois, Cecelia Bethke
Erich Astle: Sibyl Mancil, Meghan Lawson, Cristen Burrier
Voncile Kilduff: Ossie Digangi, Lorene Straub
Annamarie Sokolowski: Vallie Taormina, Mammie Watrous
Alba Bradshaw: Nathaniel Maclachlan, Milly Patterson
Lorene Straub: Brenda Lefkowitz, Voncile Kilduff, Vicenta Seidel, Kymberly Leary
Valerie Haakenson: Marry Blakely, Miki Largo, Meghan Lawson, Margaret Hoar
Cristen Burrier: Erich Astle, Kymberly Leary
Rosaura Perrino: Reggie Deguzman, Paola Emanuel, Brenda Lefkowitz, Junko Moos
Poogo Splat: Milton Teegarden, Sibyl Mancil, Roseline Fong, Latrina Kessler, Dennise Mcneel, Logan Osorio, Arminda Auman
Amee Craft: Margarita Arrey
Virgen Boyer: Ina Donley, Felisha Stillwagon, Luanna Lawrence
Masako Miguel: Dell Dillahunt, Margarita Arrey, Lilia Student, Effie Mestas, Jom Tones, Reanna Orman
Ashly Esters: Julissa Furry, Meghan Lawson, Shonta Chilson
Chrystal Deemer: Krystin Calaway, Bertie Stallcup
Renea Perrault: Dell Dillahunt, Randa Fiedler, Shawana Mell
Etsuko Swindell: Lyndia Maughan, Vicenta Seidel, Benny Giefer
Trinity Settle: Danyelle Madriz, Kathyrn Montez, Margarita Arrey
Verdie Tong: Gill Bates, Lavelle Kellman, Alton Justis
Benny Giefer: Charley Price, Etsuko Swindell
Shemika Begin: Jettie Wilham
Jacquelynn Feit: Carmel Tsuji, Arminda Auman
Ethel Beerman: Ina Donley, Halina Hamby, Shenita Boso
Ossie Digangi: Stefany Crotty, Voncile Kilduff, Song Grigg, Sindy Worley, Gill Bates, Halina Hamby
Dina Seegmiller: Claudia Mcginn, Vicenta Seidel
Farah Courchesne: Siu Buscher
Vertie Lunceford: Cathleen Healey, Kena Redwood, Arcelia Sitz
Brenda Lefkowitz: Stefany Crotty, Cliff Ayala, Lorene Straub, Rosaura Perrino, Cleora Hoch
Carno Start: Federico Rheaume, Perry Lachermeier
Kallie Helm: Alyce Orwig, Jamey Hagedorn
Shonta Chilson: Kareem Mixer, Ashly Esters, Preston Sergent, Fidel Smith, Lavelle Kellman
Milton Teegarden: Zola Luman, Vallie Taormina, Janean Catalano, Talia Leisinger, Carylon Klos, Poogo Splat
Youlanda Leveille: Avis Cabrera, Maud Atherton, Zoila Tarpey, Reanna Orman
Ina Donley: Ethel Beerman, Virgen Boyer, Blaine Byard
Tresa Candelaria: Jamey Hagedorn
Sha Pappas: Latrina Kessler, Milly Patterson, Nestor Valentine
Sharika Neal: Alyce Orwig, Danelle Poynter, Aletha Dorey
Karen Neidig: Waldo Snelson, Shantel Law, Alysa Robichaux, Delmar Mansour
Lynna Leard: Danyelle Madriz
Abbey Edberg: Kathyrn Montez, Reanna Orman
Maryland Teller: Carylon Klos
Sachiko Callaham: Reanna Orman, Mikki Yerby
Myrtis Roughton: Alysa Robichaux
Dennise Mcneel: Poogo Splat, Lavelle Kellman, Belva Lande
Mikki Yerby: Jodee Killam, Rozanne Schiavo, Sachiko Callaham, Junko Moos
Natacha Osterhoudt: Gill Bates, Ashely Flanigan
Shawana Mell: Marry Blakely, Tanesha Vanwinkle, Jettie Wilham, Renea Perrault, Arminda Auman
Siu Buscher: Louisa Willcutt, Tatiana Boeding, Cliff Ayala, Maud Atherton, Talia Leisinger, Farah Courchesne, Gia Canas
Zoila Tarpey: Ferne Dundas, Yahaira Briones, Youlanda Leveille
Waldo Snelson: Levi Strasser, Karen Neidig
Janean Catalano: Milton Teegarden, Dixie Agan, Zandra Marsch, Temple Portner
Kymberly Leary: Marquitta Platner, Dixie Agan, Lorene Straub, Cristen Burrier, Marybelle Laprade, Belva Lande
Alysa Robichaux: Yuri Mark, Edris Evanoff, Sindy Worley, Myrtis Roughton, Danelle Poynter, Karen Neidig
Vicenta Seidel: Kareem Mixer, Lorene Straub, Deena Massi, Dina Seegmiller, Etsuko Swindell
Bertie Stallcup: Kareem Mixer, Chrystal Deemer
Gia Canas: Siu Buscher
Edra Dunton: Lenita Neuhaus, Preston Sergent, Benito Calandra
Carmel Tsuji: Jacquelynn Feit, Darius Furst
Hilaria Kumar: Travis Valletta, Talia Leisinger, Cleora Hoch
Lyndsay Kee: Amos Forst, Maxima Tolleson
Margaret Hoar: Valerie Haakenson, Milly Patterson
Shonta Lacombe: Matt Chickering, Shonta Lacombe, Kareem Mixer, Isiah Oelke
Kallie Wiseman: Dell Dillahunt, Lilian Kraushaar
Whitley Fruchter: Louisa Willcutt
Blaine Byard: Ina Donley, Louisa Willcutt
Nathaniel Maclachlan: Sibyl Mancil, Alba Bradshaw
Marquitta Platner: Wen Wood, Kymberly Leary
Roseline Fong: Tanja Skiba, Poogo Splat, Darrick Hunsinger, Perry Lachermeier
Delmar Mansour: Karen Neidig, Lilian Kraushaar
Talia Leisinger: Siu Buscher, Hilaria Kumar, Milton Teegarden, Claudia Mcginn, Cody Troup
Benito Calandra: Edra Dunton, Kareem Mixer
Travis Valletta: Josef Hill, Hilaria Kumar, Jeanice Funke, Carlota Orris, Avis Cabrera
Junko Moos: Kathryne Blocker, Mammie Watrous, Temple Portner, Mikki Yerby, Rosaura Perrino
Zola Luman: Milton Teegarden
Tawny Munroe: Josef Hill
Kathryne Blocker: Junko Moos
Maxima Tolleson: Danelle Poynter, Lyndsay Kee
Lilia Student: Jodee Killam, Marybelle Laprade, Masako Miguel
Wen Wood: Marquitta Platner, Levi Strasser, Amos Forst
Shasta Cargo: Cleora Hoch, Dinorah Opp
Krystin Calaway: Hortensia Fenderson, Maud Atherton, Chrystal Deemer
Gerda Yamashiro: Tania Barberio, Arcelia Sitz
Theda Jolicoeur: Reggie Deguzman
Kareem Mixer: Shonta Chilson, Shonta Lacombe, Shantel Law, Delta Quimby, Benito Calandra, Vicenta Seidel, Bertie Stallcup
Mammie Watrous: Junko Moos, Annamarie Sokolowski
Reggie Deguzman: Theda Jolicoeur, Rosaura Perrino, Renaldo Hokanson, Marylin Tiano
Clementina Warrick: Marylin Tiano, Luanna Lawrence
Latrina Kessler: Poogo Splat, Sha Pappas
Milly Patterson: Sha Pappas, Alba Bradshaw, Jamar Mcclane, Margaret Hoar
Alyce Orwig: Kallie Helm, Sharika Neal, Paola Emanuel
Marybelle Laprade: Lilia Student, Kymberly Leary
Luanna Lawrence: Virgen Boyer, Lavelle Kellman, Clementina Warrick
Gracia Rountree: Latasha Mutch, Paola Emanuel, Lilian Kraushaar
Edris Evanoff: Tatiana Boeding, Alysa Robichaux, Federico Rheaume, Jamey Hagedorn
Miki Largo: Valerie Haakenson
Isiah Oelke: Shonta Lacombe, Cecelia Bethke
Carlota Orris: Stefany Crotty, Travis Valletta
Tanja Skiba: Felisha Stillwagon, Lucie Dossey, Roseline Fong, Criselda Jain
Cody Troup: Talia Leisinger, Oretha Linley, Reanna Orman
Paola Emanuel: Alyce Orwig, Rosaura Perrino, Gracia Rountree, Tania Barberio
Darius Furst: Marylin Tiano, Carmel Tsuji, Simone Coan
Amos Forst: Wen Wood, Lyndsay Kee, Avis Cabrera
Cecelia Bethke: Isiah Oelke, Aletha Dorey
Vallie Taormina: Milton Teegarden, Sindy Worley, Toshia Quandt, Annamarie Sokolowski
Preston Sergent: Edra Dunton, Shonta Chilson
Jeanene Antonelli: Lenita Neuhaus, Nestor Valentine
Milo Charlebois: Deena Massi, Aletha Dorey, Carylon Klos, Jettie Wilham
Arcelia Sitz: Vertie Lunceford, Gerda Yamashiro, Darrick Hunsinger
Charley Price: Sibyl Mancil, Benny Giefer
Arminda Auman: Poogo Splat, Shawana Mell, Jacquelynn Feit
Lucie Dossey: Halina Hamby, Tanja Skiba
Jettie Wilham: Lenita Neuhaus, Shemika Begin, Joey Trammell, Milo Charlebois, Shawana Mell, Dinorah Opp
Sibyl Mancil: Erich Astle, Ashely Flanigan, Nathaniel Maclachlan, Taunya Sherrell, Charley Price, Poogo Splat
Criselda Jain: Levi Strasser, Tanja Skiba
Jodee Killam: Gill Bates, Lilia Student, Mikki Yerby
Kathyrn Montez: Trinity Settle, Dell Dillahunt, Abbey Edberg
Ignacio Dresser: Delta Quimby, Lyndia Maughan
Danelle Poynter: Maxima Tolleson, Sharika Neal, Alysa Robichaux
Dinorah Opp: Debrah Kanagy, Shasta Cargo, Jettie Wilham
Dell Dillahunt: Kennith Estelle, Masako Miguel, Cathleen Healey, Renea Perrault, Kathyrn Montez, Kallie Wiseman
Matt Chickering: Cathleen Healey, Shonta Lacombe
Marylin Tiano: Reggie Deguzman, Clementina Warrick, Darius Furst
Maud Atherton: Siu Buscher, Nestor Valentine, Youlanda Leveille, Krystin Calaway
Nestor Valentine: Tanesha Vanwinkle, Shenita Boso, Maud Atherton, Jeanene Antonelli, Sha Pappas
Kena Redwood: Vertie Lunceford, Yuri Mark
Logan Osorio: Poogo Splat
Levi Strasser: Waldo Snelson, Wen Wood, Criselda Jain, Enrique Litz
Lavelle Kellman: Dennise Mcneel, Verdie Tong, Shonta Chilson, Luanna Lawrence
Lenita Neuhaus: Jeanene Antonelli, Edra Dunton, Shanel Mattson, Jettie Wilham
Federico Rheaume: Edris Evanoff, Carno Start
Song Grigg: Hortensia Fenderson, Yuri Mark, Ossie Digangi, Monet Martello
Shenita Boso: Stefany Crotty, Ethel Beerman, Trinh Siegle, Nestor Valentine, Oretha Linley
Temple Portner: Janean Catalano, Junko Moos
Shantel Law: Kareem Mixer, Karen Neidig
Lyndia Maughan: Debrah Kanagy, Etsuko Swindell, Ignacio Dresser
Halina Hamby: Lucie Dossey, Ossie Digangi, Ethel Beerman
Darrick Hunsinger: Roseline Fong, Arcelia Sitz
Kimberlie Chiang: Julissa Furry
Tatiana Boeding: Siu Buscher, Edris Evanoff
Trinh Siegle: Fidel Smith, Shenita Boso, Debrah Kanagy
Hue Hatchett: Cleora Hoch, Renaldo Hokanson
Randa Fiedler: Alberto Liner, Renea Perrault
Renaldo Hokanson: Claudia Mcginn, Reggie Deguzman, Hue Hatchett
Julissa Furry: Ashly Esters, Effie Mestas, Kimberlie Chiang
Ophelia Benavidez: Taunya Sherrell
Stefany Crotty: Shenita Boso, Ossie Digangi, Jamey Hagedorn, Carlota Orris, Brenda Lefkowitz
Ashely Flanigan: Sibyl Mancil, Natacha Osterhoudt
Minta Caicedo: Claudia Mcginn, Meghan Lawson, Simone Coan
Elmira Joye: Avis Cabrera, Lilian Kraushaar
Perry Lachermeier: Roseline Fong, Carno Start
Avis Cabrera: Travis Valletta, Amos Forst, Elmira Joye, Youlanda Leveille
Debrah Kanagy: Lyndia Maughan, Hortensia Fenderson, Trinh Siegle, Dinorah Opp
Felisha Stillwagon: Virgen Boyer, Tanja Skiba
Tania Barberio: Paola Emanuel, Gerda Yamashiro, Reanna Orman
Marry Blakely: Jom Tones, Valerie Haakenson, Delta Quimby, Shawana Mell
Danyelle Madriz: Trinity Settle, Lynna Leard
Jamar Mcclane: Tanesha Vanwinkle, Milly Patterson
Daine Turnage: Zandra Marsch
Jeanice Funke: Travis Valletta, Toshia Quandt
Fidel Smith: Alberto Liner, Trinh Siegle, Shonta Chilson
Delta Quimby: Marry Blakely, Kareem Mixer, Ignacio Dresser
Taunya Sherrell: Sibyl Mancil, Meghan Lawson, Ophelia Benavidez
Meghan Lawson: Erich Astle, Minta Caicedo, Ashly Esters, Valerie Haakenson, Taunya Sherrell
Zandra Marsch: Daine Turnage, Yahaira Briones, Janean Catalano
Louisa Willcutt: Siu Buscher, Jayna Leclaire, Oretha Linley, Whitley Fruchter, Blaine Byard
Margarita Arrey: Amee Craft, Simone Coan, Masako Miguel, Trinity Settle, Ferne Dundas
Latasha Mutch: Gracia Rountree
Dixie Agan: Janean Catalano, Kymberly Leary
Claudia Mcginn: Dina Seegmiller, Talia Leisinger, Renaldo Hokanson, Minta Caicedo
Jayna Leclaire: Louisa Willcutt
Alberto Liner: Fidel Smith, Randa Fiedler
Carylon Klos: Maryland Teller, Milton Teegarden, Milo Charlebois
Belva Lande: Dennise Mcneel, Kymberly Leary
Kennith Estelle: Dell Dillahunt
Simone Coan: Darius Furst, Margarita Arrey, Minta Caicedo
Hortensia Fenderson: Song Grigg, Krystin Calaway, Debrah Kanagy
Jamey Hagedorn: Stefany Crotty, Kallie Helm, Tresa Candelaria, Edris Evanoff
Cathleen Healey: Vertie Lunceford, Dell Dillahunt, Matt Chickering
Oretha Linley: Cody Troup, Louisa Willcutt, Shenita Boso
Lilian Kraushaar: Elmira Joye, Gracia Rountree, Kallie Wiseman, Delmar Mansour
Cleora Hoch: Hilaria Kumar, Hue Hatchett, Shasta Cargo, Brenda Lefkowitz, Reanna Orman
Reanna Orman: Abbey Edberg, Masako Miguel, Sachiko Callaham, Youlanda Leveille, Cody Troup, Cleora Hoch, Tania Barberio
Yuri Mark: Song Grigg, Kena Redwood, Alysa Robichaux
Monet Martello: Song Grigg
Cliff Ayala: Siu Buscher, Brenda Lefkowitz
Shanel Mattson: Lenita Neuhaus
